11111111
10000001
1P00C001
11111111
