11111111111111
1000011
11111111111111
10000111
11111111111111
1000011
11111111111111
1000011 
11111111111111
