11111111
10000001
10000001
10000001
10000001
1ECP0001
10000001
11111111
