111111111111111
1E000000C000001
100000000000001
100001111110001
100000000000001
100000000000001
1000000000000P1
