11111111
10000001
1ECP0001
11111111
