111111111111111
100000C000000X1
100000000000001
10010000X000001
1000C00000000C1
1E000000X0000P1
111111111111111
