11111111
100000E1
11001101
1CP00001
11111111
