11111111
1P0011E1
1000C101
10000001
11111111
