11111111
1C00C0E1
10000001
1P000001
11111111
