11111111
1C00C0E1
10111111
1P00C001
11111111
