11111111
100000E1
1P00C001
10000000
11111111
