11111111
1CCC00E1
100000C1
1P000001
11111111
