111111111111111
100000C00000001
100000000000001
100100000000001
1000C00000000C1
1E00000000000P1
111111111111111
