111111111111111
1P0000C00000001
100001111110001
1000000C0000001
1000C0000C000C1
1E0000000000001
111111111111111
