1111
1E01
1001
10P1
1001
1C01
1111
