111111111111111
100010C00000001
100011111110001
1001000C0000001
1110C0000C000C1
1E0000000000CP1
111111111111111
