11111111
1P00C0E1
10000X01
11111111
