11111111111
1P00000X001
10C00C00C01
10010101011
100X000X001
10010101011
10X001110X1
10010001001
10001111001
1X000X000X1
1000C000001
10000C000E1
11111111111
