111111111111111
100000C000000X1
10000X000000001
1E010000X000001
1000C00000000C1
10000000X0000P1
111111111111111
